%%%%%%%%%%%%%%%%%%%%%%%%%%%%
%.           %%           .%
% %%%% %%%%% %% %%%%% %%%% %
% %%%% %%%%% %% %%%%% %%%% %
% %%%% %%%%% %% %%%%% %%%% %
%                          %
% %%%% %% %%%%%%%% %% %%%% %
% %%%% %% %%%%%%%% %% %%%% %
%      %%    %%    %%      %
%%%%%% %%%%% %% %%%%% %%%%%%
%    % %%          %% %    %
%    % %%          %% %    %
%%%%%% %% %%%%%%%% %% %%%%%%
%         %      %         %
%%%%%% %% %%%%%%%% %% %%%%%%
%    % %%          %% %    %
%    % %%          %% %    %
%%%%%% %% %%%%%%%% %% %%%%%%
%            %%            %
% %%%% %%%%% %% %%%%% %%%% %
% %%%% %%%%% %% %%%%% %%%% %
%   %%       P        %%   %
%%% %% %% %%%%%%%% %% %% %%%
%%% %% %% %%%%%%%% %% %% %%%
%      %%    %%    %%      %
% %%%%%%%%%% %% %%%%%%%%%% %
% %%%%%%%%%% %% %%%%%%%%%% %
%.                        .%
%%%%%%%%%%%%%%%%%%%%%%%%%%%%
