%%%%%%%%%%%%%%%%%%%%%%%%%%%%
%............%%............%
%.%%%%.%%%%%.%%.%%%%%.%%%%.%
%.%%%%.%%%%%.%%.%%%%%.%%%%.%
%.%%%%.%%%%%.%%.%%%%%.%%%%.%
%..........................%
%.%%%%.%%.%%%%%%%%.%%.%%%%.%
%.%%%%.%%.%%%%%%%%.%%.%%%%.%
%......%%....%%....%%......%
%%%%%%.%%%%% %% %%%%%.%%%%%%
%    %.%%          %%.%    %
%    %.%%          %%.%    %
%%%%%%.%% %%%%%%%% %%.%%%%%%
%     .   %      %   .     %
%%%%%%.%% %%%%%%%% %%.%%%%%%
%    %.%%          %%.%    %
%    %.%%          %%.%    %
%%%%%%.%% %%%%%%%% %%.%%%%%%
%............%%............%
%.%%%%.%%%%%.%%.%%%%%.%%%%.%
%.%%%%.%%%%%.%%.%%%%%.%%%%.%
%...%%.......P........%%...%
%%%.%%.%%.%%%%%%%%.%%.%%.%%%
%%%.%%.%%.%%%%%%%%.%%.%%.%%%
%......%%....%%....%%......%
%.%%%%%%%%%%.%%.%%%%%%%%%%.%
%.%%%%%%%%%%.%%.%%%%%%%%%%.%
%..........................%
%%%%%%%%%%%%%%%%%%%%%%%%%%%%
